0 4 1 4 1 7 0 7 0 7 1 6 1 6 0
0 0 2 1 2 1 0 0 0 1 2 1 2 0 0
0 4 1 4 1 7 3 7 3 7 1 6 1 6 0
2 1 2 1 7 3 3 1 3 3 7 1 2 1 2
1 7 1 7 3 3 7 0 7 3 3 7 1 7 1
2 0 3 0 0 7 1 1 1 7 0 0 3 0 2
2 7 1 7 0 2 8 8 8 2 0 7 1 7 2
2 0 3 0 0 7 1 1 1 7 0 0 3 0 2
1 7 1 7 3 3 7 2 7 3 3 7 1 7 1
2 1 2 1 7 3 3 1 3 3 7 1 2 1 2
0 6 1 6 1 7 3 7 3 7 1 5 1 5 0
0 0 2 1 2 1 0 0 0 1 2 1 2 0 0
0 6 1 6 1 7 0 7 0 7 1 5 1 5 0